100000000000000002220000000000000000000000000000000000000000000000000000000000000000000000000000000000000002220000000000
110000022222000000000000220000000000022222000000000000000000000000022222000000000000000000000000022222000000000000000011
110000000000000000000000000000000000010001110000000000000000000000000000000000000000000000000000000000000000000000000011
220000000000000002200000022000220000010000000002200000022000220000000000000002200000022000220000000000000000000000000011
110000000000000221100002211200112222222222022221100002211200112222222222222221100002211200112222210000000000000000000011
111000000000000100001111111110111100000000011111111111111111111111111111111111111111111111111111110000000222000000011111
111100000000000100011111111110000001111000111111111111111111100011111110000000011111111111111111111110000010000000111111
111111111111111111111111111111111111111111100011111111111111111111111112222222211111111111111111111111000010000000111111
111111111111111111111111111111111111111111111111111111111111111111111111111111111111111111111111111111111111111111111111
111111111111111111111111111111111111111111111111111111111111111111111111111111111111111111111111111111111111111111111111
111111111111111111111111111111111111111111111111111111111111111111111111111111111111111111111111111111111111111111111111
111111111111111111111111111111111111111111111111111111111111111111111111111111111111111111111111111111111111111111111111
111111111111111111111111111111111111111111111111111111111111111111111111111111111111111111111111111111111111111111111111